NO ./textures/north.xpm
SO ./textures/southbrick.xpm
WE ./textures/east.xpm
EA ./textures/west.xpm

F 12,120,12
C 12,12,12

11111111111111111111111111111111111111111111111111111111111111111111111111111111111111111111111111111111111111111111111111111111111111111111111111111111111111111111111111111111111111111
110000000000000000000000000000000000000000000000000000000000000000000011111111111111111111
110000000000000000000000000000000000000000000000000000000000000000000011111111111111111111
110000000000000000000000000000000000000000000000000000000000000000000011111111111111111111
110000000000000000000000000000000000000000000000000000000000000000000011111111111111111111
110000000000000000000000000000000000000000000000000000000000000000000011111111111111111111
110000000000000000000000000000000000000000000000000000000000000000000011111111111111111111
110000000000000000000000000000000000000000000000000000000000000000000011111111111111111111
110000000000000000000000000000000000000000000000000000000000000000000011111111111111111111
110000000000000000000000000000000000000000000000000000000000000000000011111111111111111111
110000000000000000000000000000000000000000000000000000000000000000000011111111111111111111
110000000000000000000000000000000000000000000000000000000000000000000011111111111111111111
110000000000000000000000000000000000000000000000000000000000000000000011111111111111111111
110000000000000000000000000000000000000000000000000000000000000000000011111111111111111111
110000000000000000000000000000000000000000000000000000000000000000000011111111111111111111
110000000000000000000000000000000000000000000000000000000000000000000011111111111111111111
110000000000000000000000000000000000000000000000000000000000000000000011111111111111111111
110000000000000000000000000000000000000000000000000000000000000000000011111111111111111111
110000000000000000000000000000000000000000000000000000000000000000000011111111111111111111
110000000000000000000000000000000000000000000000000000000000000000000011111111111111111111
110000000000000000000000000000000000000000000000000000000000000000000011111111111111111111
110000000000000000000000000000000000000000000000000000000000000000000011111111111111111111
110000000000000000000000000000000000000000000000000000000000000000000011111111111111111111
110000000000000000000000000000000000000000000000000000000000000000000011111111111111111111
110000000000000000000000000000000000000000000000000000000000000000000011111111111111111111
110000000000000000000000000000000000000000000000000000000000000000000011111111111111111111
110000000000000000000000000000000000000000000000000000000000000000000011111111111111111111
110000000000000000000000000000000000000000000000000000000000000000000011111111111111111111
110000000000000000000000000000000000000000000000000000000000000000000011111111111111111111
110000000000000000000000000000000000000000000000000000000000000000000011111111111111111111
110000000000000000000000000000000000000000000000000000000000000000000011111111111111111111
110000000000000000000000000000000000000000000000000000000000000000000011111111111111111111
110000000000000000000000000000000000000000000000000000000000000000000011111111111111111111
110000000000000000000000000000000000000000000000000000000000000000000011111111111111111111
110000000000000000000000000000000000000000000000000000000000000000000011111111111111111111
110000000000000000000000000000000000000000000000000000000000000000000011111111111111111111
110000000000000000000000000000000000000000000000000000000000000000000011111111111111111111
110000000000000000000000000000000000000000000000000000000000000000000011111111111111111111
110000000000000000000000000000000000000000000000000000000000000000000011111111111111111111
110000000000000000000000000000000000000000000000000000000000000000000011111111111111111111
110000000000000000000000000000000000000000000000000000000000000000000011111111111111111111
110000000000000000000000000000000000000000000000000000000000000000000011111111111111111111
110000000000000000000000000000000000000000000000000000000000000000000011111111111111111111
110000000000000000000000000000000000000000000000000000000000000000000011111111111111111111
110000000000000000000000000000000000000000000000000000000000000000000011111111111111111111
1100N00000000000000000000000000000000000000000000000000000000000000000000001
1100000000000000000000000000000000000000000000000000000000000000000000011111111
1100000000000000000000000000000000000000000000000000000000000000000000011111111
1100000000000000000000000000000000000000000000000000000000000000000000011111111
1100000000000000000000000000000000000000000000000000000000000000000000011111111
1100000000000000000000000000000000000000000000000000000000000000000000011111111
1100000000000000000000000000000000000000000000000000000000000000000000011111111
1100000000000000000000000000000000000000000000000000000000000000000000011111111
11111111111111111111111111111111111111111111111111111111111111111111111111111111111111111111111111111111111111111111111111111111111111111111111111111111111111111111111111111111111111111
