NO ./textures/north.xpm
SO ./textures/southbrick.xpm
WE ./textures/west.xpm
EA ./textures/east.xpm

F 25,10,0
C 25,30,0

  1111111111111111111111111
  1000000000110000000000001 
  1011000001110000000000001 
  1001000000000000000000001111111
111111111011000001110000000000001
100000000011000001110111111111111 
11110111111111011100000010001    
1111011111111101110101001001
1100000011010101110000001111
10000000000000001100000010001
10000000000000001101010000001
110W000111010101111101111010111
11110111 1110101 11 1111 11111
11111111 1111111 1111111