NO ./textures/ceiling.xpm
SO ./textures/ceiling.xpm
WE ./textures/ceiling.xpm
EA ./textures/ceiling.xpm

F 220,100,0
C 225,30,0

  1111111111111111111111111 
  1000000000110000000000001 
  1011000001110000000000001 
  1001000000000000000000001 
111111111011000001110000000000001
100000000011000001110111111111111 
11110111111111011100000010001    
1111011111111101110101001001
1100000011010101110000001111
10000000000000001100000010001
10000000000000001101010010001
11000001110101011111011110N0111
11110111 1110101 11 1111010001
11111111 1111111 1111111