NO ./textures/north1.xpm
SO ./textures/southbrick.xpm
WE ./textures/west3.xpm
EA ./textures/east4.xpm

F   200,200,120
C   188,210,244

111111
101111
101111
101111
101111
101111
100101
1N0001
111111
